一騎	一骑	男 土岐遠一騎
カズキ	一骑	男 土岐遠一騎
トキ	远	男 土岐遠一騎
カスミ	霞	女 土岐遠カスミ 一騎の従姉
土岐遠	土岐远	一騎・カスミの苗字
リア	莉亚	女 リア・ベルリオーズ
ベルリオーズ	贝尔里奥兹	女 リア・ベルリオーズ
銀	银	女 水音銀
ギン	银	女 水音銀
エルス	艾尔斯	女 エルステリア・マリーゴールド キャロラインの妹
キャロライン	卡罗琳	女 キャロライン・マリーゴールド エルステリアの姉
クリスティン	克里斯汀	女 クリスティン・マックウォーター 水音銀の別名
マリーゴールド	玛丽戈尔德	女 エルステリア・キャロラインの苗字
マックウォーター	麦克沃特	クリスティン・マックウォーター

ステッチ	缇奇	男 女装 メイド
バビィ	巴比	男 執事長 鳥
京司	京司	男 浅川京司
浅川	浅川    	男 浅川京司
ユナハ	尤娜哈	女 ユナハ・クリスティ 舞踊講師
クリスティ	克里斯蒂	女 ユナハ・クリスティ 舞踊講師
アズ	亚兹	男 アズラエル ぬいぐるみ

水路	水渠
スプリングスノー	春雪树	汚染を浄化で大樹
春雪	春雪	スプリングスノーの花
虹色の羽	虹光之翼
ベルティナ	贝尔蒂娜	舞手
エルディス	艾尔蒂斯	エルディス・ベルティナ ベルティナの中で特に優れた者

舞踊	舞蹈
祭具	祭具	舞踊に使う道具
アスティリア	星彩	エルスの杖形祭具
アルカンシエル	日晕	リアのング形祭具
エバーグリーン	常青	カスミの扇形祭具
エルドラド	金辉	銀の双剣形祭具
プリムローズ	春曦	キャロラインのリボン形祭具

アイレ	艾尔	物語の舞台となる街
クラン	克兰	アイレの地域
ウィスカ	维斯卡	アイレの地域
ウーイル	乌伊尔	アイレの地域
ソーラス	索拉斯	アイレの地域
アナム	阿纳姆	アイレの地域
グィー	古伊	アイレの地域
ティーナ	帝娜	アイレの地域

アルガロ・デ・モンド祭	阿尔加罗·德·蒙多祭
ミルレイス・スノー祭	米尔雷斯雪祭
水路下り	水渠漂流
