アルヴィース	阿尔维斯	アルヴィース魔法魔術学院

デュオ	迪欧	男 デュランダル＝ファーネク 視点
デュランダル	杜兰达尔	男 デュランダル＝ファーネク 視点
ファーネク	费尔内克 	男 デュランダル＝ファーネク 視点

シャル	夏洛	女 シャルロッテ＝カミル＝ハーリンガム
シャルロッテ	夏洛特	女 シャルロッテ＝カミル＝ハーリンガム
カミル	卡密尔	女 シャルロッテ＝カミル＝ハーリンガム
ハーリンガム	哈林肯	女 シャルロッテ＝カミル＝ハーリンガム

ローラ	罗拉	女 フローリアム＝ブロセリアンド
フローリアム	弗罗莉亚姆	女 フローリアム＝ブロセリアンド
ブロセリアンド 	普罗瑟里安德	女 フローリアム＝ブロセリアンド

アリス	爱丽丝	女 アリス＝アリステル＝ファーネク
アリステル	爱丽丝提尔	女 アリス＝アリステル＝ファーネク
ファーネク	法奈克	女 アリス＝アリステル＝ファーネク

グラニテ	古拉妮蒂	女 グラニティアーナ＝クリスティア
グラニティアーナ	古拉妮蒂安娜	女 グラニティアーナ＝クリスティア
クリスティア	克里丝蒂亚	女 グラニティアーナ＝クリスティア

ソフィア	索菲娅	女 ソフィアーシェ＝ラフォニット
ソフィアーシェ	索菲娅修	女 ソフィアーシェ＝ラフォニット
ラフォニット	拉冯尼特	女 ソフィアーシェ＝ラフォニット

ディアナ	戴安娜	女 ディアナ＝セレンディル
セレンディル	塞兰迪尔	女 ディアナ＝セレンディル

ルル	露露	女 ルルガノ＝ヤヌシェ＝エンフィヌス
ルルガノ	露露加诺	女 ルルガノ＝ヤヌシェ＝エンフィヌス
ヤヌシェ	杰纳斯	女 ルルガノ＝ヤヌシェ＝エンフィヌス
エンフィ	恩菲	女 ルルガノ＝ヤヌシェ＝エンフィヌス
エンフィヌス	恩菲纳斯	女 ルルガノ＝ヤヌシェ＝エンフィヌス


リオル	利奥鲁	男 エスタリオル＝アルク＝レヌスベルン
エスタリオル	埃斯塔利奥鲁	男 エスタリオル＝アルク＝レヌスベルン
アルク	阿鲁库	男 エスタリオル＝アルク＝レヌスベルン
レヌスベルン	兰努斯贝伦	男 エスタリオル＝アルク＝レヌスベルン

スニーク	斯尼库	男
ヴァレン	瓦伦	男 スニーク

ネーブル	纳维鲁	男
ネーブルステア	纳维鲁斯特	男 ネーブル

ルヴィース	路易斯
フランツ	弗兰茨

ウィズ	魔法使
エールフィン	精灵
エルフ	精灵

ウィズアニバーサリィー	魔法使纪念日
ウィズアニ	魔法使纪念日

<汗>	<汗>	emoji, keep as is
<愛>	<愛>	emoji, keep as is
<汁>	<汁>	emoji, keep as is
<怒>	<怒>	emoji, keep as is
