ねえ	呐
ちゃん	酱
ごきげんよう	贵安
昇降口	大门
赤飯	红豆饭
せきはん	红豆饭
囃子	伴奏
型抜き	椪糖
スク水	死库水

JS	JS
JC	JC
JK	JK
J〇	J〇

プレイ	Play
ピストン	活塞
シックスナイン	69

メスガキ	雌小鬼
ちっぱい	贫乳
つるぺた	平板
イカ腹	鱿鱼肚
イカばら	鱿鱼肚
いかばら	鱿鱼肚
デベソ	脐凸

躾	调教
電マ	按摩棒
バイブ	按摩棒
ディルドー	假阳具
ローター	跳蛋
クスコ	鸭嘴钳
バストバキューム	榨乳器
我慢汁	忍耐汁
カウパー腺液	先走汁
雑魚	杂鱼
マゾ	抖M
マゾヒズム	抖M
サディズム	抖S
オカズ	配菜
脳汁	脑汁	脳内で分泌される快楽物質による感覚を表現した俗語
スティミュラント	兴奋剂
オナホ	飞机杯

膣	小穴
まんこ	小穴
まんまん	小穴穴
クリトリス	阴蒂
クリちゃん	小豆豆
お豆	小豆豆
まんすじ	阴阜
ほうけい	包茎
裏筋	系带
ちんこ	鸡鸡
ちんぽ	鸡鸡
ちんちん	小鸡鸡
アナル	菊穴
露出	露出
手まん	指奸
手マン	指奸
手こき	手冲
手コキ	手冲
寸止め	寸止
ぶっかけ	浇汁
