オマンコ	おまんこ
オマンマン	おまんまん
オチンコ	おちんこ
オチンポ	おちんぽ
オチンチン	おちんちん
マンコ	まんこ
マンマン	まんまん
チンコ	ちんこ
チンポ	ちんぽ
チンチン	ちんちん

しきゅ	子宮
アヌス	肛門
アナル	肛門
ザーメン	精液
せーえき	精液
じゃーめん	精液
せーし	精子

なからし	中出し
ながりゃ	ながら
なきゃに	中に

ユー〇ューバー	Youtuber

幼〇	幼女
よ〇じょ	幼女
園〇	園児
〇稚園	幼稚園
〇供	子供
ロ〇	ロリ
〇リ	ロリ
〇〇の子	ロリの子
〇〇っ子	ロリっ子
〇〇っ娘	ロリっ娘

小〇生	小学生
中〇生	中学生

〇ンドセル	ランドセル
ラ〇ドセル	ランドセル
ラン〇セル	ランドセル
ランド〇ル	ランドセル
ランドセ〇	ランドセル
〇〇ドセル	ランドセル
〇ン〇セル	ランドセル
〇ンド〇ル	ランドセル
〇ンドセ〇	ランドセル
ラ〇〇セル	ランドセル
ラ〇ド〇ル	ランドセル
ラ〇ドセ〇	ランドセル
ラン〇〇ル	ランドセル
ラン〇セ〇	ランドセル
ランド〇〇	ランドセル
〇〇〇セル	ランドセル
〇〇ド〇ル	ランドセル
〇〇ドセ〇	ランドセル
〇ン〇〇ル	ランドセル
〇ン〇セ〇	ランドセル
〇ンド〇〇	ランドセル
ラ〇〇〇ル	ランドセル
ラ〇〇セ〇	ランドセル
ラ〇ド〇〇	ランドセル
ラン〇〇〇	ランドセル

〇スガキ	メスガキ
メ〇ガキ	メスガキ
メス〇キ	メスガキ
メスガ〇	メスガキ
〇〇ガキ	メスガキ
〇ス〇キ	メスガキ
〇スガ〇	メスガキ
メ〇〇キ	メスガキ
メ〇ガ〇	メスガキ
メス〇〇	メスガキ

〇ソガキ	クソガキ
ク〇ガキ	クソガキ
クソ〇キ	クソガキ
クソガ〇	クソガキ
〇〇ガキ	クソガキ
〇ソ〇キ	クソガキ
〇ソガ〇	クソガキ
ク〇〇キ	クソガキ
ク〇ガ〇	クソガキ
クソ〇〇	クソガキ

ち〇ち	ちんち
チ〇チ	ちんち
チ〇コ	ちんぽ
ち〇こ	ちんぽ
チ〇ポ	ちんぽ
ち〇ぽ	ちんぽ
ま〇こ	まんこ
マ〇コ	まんこ
〇んちん	ちんちん
〇ンチン	ちんちん
〇んまん	まんこ
〇ンマン	まんこ

奴〇	奴隷
催〇	催眠
強〇	強姦
輪〇	輪姦
レ〇プ	強姦
触手〇	触手姦
機械〇	機械姦
