ご主人様	主人	男 視点

アイ	爱	女 AI アンドロイド
葵葉	葵叶	女
ミルク	牛奶	女
クルミ	胡桃	女
めい	芽衣	女
つむぎ	柚希	女
みお	美绪	女
あゆみ	步美	女
めぐ	惠	女
あすか	飞鸟	女
ののか	和花	女
きょうこ	响子	女
しおん	诗音	女
あかり	光	女
なな	七七	女
ちあき	智秋	女
とうか	冬佳	女
こはる	小春	女
にな	仁奈	女
ましろ	真白	女
るな	露娜	女
るり	琉璃	女
ゆう	优	女
ゆめ	梦	女
みこと	美琴	女
あかね	爱铃	女
ウェルザ	薇儿丹蒂	女
ウルズ	乌尔德	女
スクルド	诗蔻蒂	女
マジカルここな	魔法心叶	女
淫乱な教え子	淫乱的学生	女
無邪気な愛娘	天真的爱女	女
メスガキな姪っ子	雌小鬼侄女	女
ダウナーな妹	消沉系妹妹	女

黒幕の男？	幕后的男人？
システム	系统
シナリオ	旁白

オナ	自慰
オナサポ	自慰支援
しこしこボイス	撸动提示音
ペース	节奏

滝登り	逆流攀升
射精寸前	边缘控制
緩急激しめ	缓急波动
安定スロー	稳定慢速
運試	碰运气

マゾペット	抖M宠物
アンドロイド	机器人
ゲージ	计量条
メーター	计量表

黄泉の国	冥界
エロトラップダンジョン	色情陷阱迷宫
ショッピングモール	购物中心
