博士	博士	男 視点
ひろし	博士	男 視点
真部	真部	真部博士 男 視点
まなべ	真部	真部博士 男 視点
綾霞	绫霞	女 退魔師
日野宮	日野宫	日野宮綾霞 女
深月	深月	女 日野宮綾霞
恵	惠	女
星野	星野	恵の苗字
こるり	小琉璃	女
香織	香织	女
かおり	香织	女
今日野	今日野	今日野香織 女
美弥	美弥	女
三ツ矢	三矢	三ツ矢美弥 女
陽子	阳子	女
永輪	永轮	永轮陽子 女
雪那	雪那	女 真名の母
奥里	奥里	奥里雪那 女 真名の母
瑠璃	琉璃	女 雪女
るり	琉璃	女 雪女
ルリ	琉璃	女 雪女
双葉	双叶	女 若葉の姉
若葉	若叶	女 双葉の妹
わかば	若叶	女 双葉の妹
園村	园村	双叶/若叶の苗字

疾月	疾月	男 綾霞の兄
はやつき	疾月	男 綾霞の兄
寿	寿	男 陽子の兄
永輪	永轮	永輪寿 男 陽子の兄
由里乃	由里乃	女
篠崎	篠崎	篠崎由里乃 女
弓削	弓削	男

真名	真名	女 雪那の娘
まな	真名	女 雪那の娘
沢田	泽田	男 美弥の恋人
真砂	真砂	女 雪那の叔母
高木	高木	男 科学部顧問の教師

愛美	爱美	女
咲美	咲美	女
のぞみ	望	女
香奈恵	香奈恵	女
早苗	早苗	女
真奈美	真奈美	女
亜美	亚美	女
瑠美	瑠美	女

美佐子	美佐子	女
美雪	美雪	女
真雪	真雪	女
まゆき	真雪	女
ユミネェ	尤米娜	女
奈未	奈未	女
青山	青山	男
店長	店长	男
ジョニー	强尼	男
タマ	球球	猫

おばさん	阿姨
おばちゃん	大婶
お隣のオバさん	邻居大婶
ガキんちょ	小鬼


雪女	雪女
雪女の里	雪女之里
パンダロボ	熊猫机器人
闇纏い	暗缠	闇をまとった鬼
閑古鳥	杜鹃鸟

超常現象研究部	超自然现象研究部

繁華街	繁华街
校門	校门
中庭	中庭
教室	教室
科学部	科学部
職員室	职员室
廊下	走廊
自宅	家
公園	公园
長老	长老
駄菓子屋	粗点心店
神社	神社
民家	民宅
廃屋	废屋
病院	医院
花屋	花店
八百八	八百八
魚八	鱼八
暇潰しをします	打发时间
マップ	地图
