俺	我	男
ネイヴィル	纳威	男
コロン	科隆	男

きらり	琪拉拉	女
ゆづき	柚木	女
アンバー	琥珀	女
クレア	克莱尔	女
ジュネ	香猫	女
ノノ	诺诺	女
バニッサ	芭妮莎	女
ミリー	米莉	女
ムツリ	茉莉	女
メイム	梅姆	女
モルティーナ	莫蒂娜	女
ヤーミ	雅美	女
ルージュ	露珠	女
マリアージュ	玛丽亚	女
ティル	蒂露	女
ねね	宁宁	女
テンテン	点点	女

ケルガロス	凯尔加洛斯	女
プリシア	普莉希娅	女
ゲイル	盖尔	女
ミシェル	米歇尔	女
アルベール	阿尔贝尔	女
ケイシー	凯西	女
エリオット	艾略特	女
ローザ	罗莎	女
るか	露卡	女
ミーア	米娅	女

あまのじゃく	天邪鬼	女
えむはぴ	えむはぴ	女
えるふ	精灵	女
かべどら	かべどら	女
くまむすめ	熊娘	女
さきゅばす	魅魔	女
すらいむ	史莱姆	女
だうなーすらいむ	下流史莱姆	女
つぼみのせい	花蕾精	女
とらあねき	虎姐	女
どじねこ	笨猫	女
どらごん	龙	女
にゃんころ	喵喵	女
ばにうさ	兔女郎	女
ふうきいぬ	风犬	女
ふぇありぃ	小精灵	女
ぽにいてえるふ	小马精灵	女
まじょ	魔女	女
みずぎつね	泳衣狐	女
みるたうろす	米尔牛头人	女
もぐもぐ	嚼嚼	女
アグム	阿古姆	女
アナコンダ	巨蟒	女
アンディ	安迪	女
イヤーナ	伊亚娜	女
ウィスプ	幽灵	女
ウィズ	威兹	女
オルドー	奥尔多	女
オーク	兽人	女
ガブリバナ	食人花	女
クロウ	乌鸦	女
グオー	咕咕	女
コバチ	小蜂	女
ゴブ	哥布	女
ゴブリン	哥布林	女
ジャイアントビー	巨型蜜蜂	女
スライム	史莱姆	女
ダケダケ	竹岳	女
デモンドラゴ	恶魔龙	女
トレント	树人	女
ドクラッシュ	毒碎	女
ネズミン	小老鼠	女
ノーム	妖精	女
バジーク	巴吉克	女
パタン	帕坦	女
ヒュドラ	九头蛇	女
フェニックス	凤凰	女
ブラウンベア	棕熊	女
ミノタウロス	米诺陶洛斯	女
ミミック	拟态怪	女
ミミミック	拟态怪王	女
ミミミミック	拟态怪皇	女
メイグイ	玫瑰	女
メイム	梅姆	女
ユニコーン	独角兽	女
ラボス	拉博斯	女
リザイアン	利扎安	女

エッグアイ	蛋眼	男
ゲノム	基因体	男
デスアーム	死亡之臂	男
デスエッグ	死亡之蛋	男
ワームデーモン	蠕虫恶魔	男
不落の鬼	不落之鬼	男
無属性	无属性	男
腐敗戦士	腐败战士	男

ちんこの部屋	肉棒之室
へその部屋	脐之室
口の部屋	口之室
手の部屋	手之室
物置部屋	储藏室
絵画のスイッチ部屋	画作切换室
胸の部屋	胸之室
足の部屋	足之室
監禁部屋	监禁房间

栄養ドリンク	营养饮料
力の果実	力量果实
魔力の果実	魔力果实
魔力草	魔力草
黄金水	黄金水
北の洞窟	北之洞窟
凍った毒薬	冷冻毒药
催涙スプレー	催泪喷雾
マップ上の亀	地图上的龟
モンスター娘	魔物娘
古のペンダント	远古吊坠

バック	后面

ギャラリー	回想画廊
にちゃにちゃソフト	喵喵软件
初めにお読みください	请先阅读
