ぷーさん	小熊哥	男 視点
ぷーたろ	废熊太郎	ぷーさん 男 視点
プータロ	废熊太郎	ぷーさん 男 視点

英美	英美	女 シスター
ルーシー	露丝	女 シスター
ミー	我	女 ルーシー

ゆかり	悠佳莉	芦屋ゆかり ママ 芦屋家の母
梓	梓	芦屋梓 芦屋家の長女
美沙	美沙	芦屋美沙 芦屋家の次女
麻亜子	麻亚子	芦屋麻亜子 芦屋家の三女
まァこ	小麻	麻亜子 芦屋家の三女
芦屋	芦屋	ゆかり/梓/美沙/麻亜子 女

サラ 	萨拉	女 麻亜子の友人
たまえ 	玉爱	女 麻亜子の友人
たま 	玉	たまえ 女 麻亜子の友人
ともよ 	友叶	女 麻亜子の友人

猫柳の爺	猫柳老爷子	猫柳氏 男 寒椿會のヌシ
猫柳	猫柳	猫柳氏 男 寒椿會のヌシ
ゆりあ	悠莉亚	女
みによん	娇妮	女

アカペラ	清唱
