静真	静真	男 支仓静真
シズマ	静真	男 支仓静真
有希奈	有希奈	女 巴有希奈 真紀奈の姉
ユキ	有希奈	女 巴有希奈 真紀奈の姉
真紀奈	真纪奈	女 巴真紀奈 有希奈の妹
マキ	真纪奈	女 巴真紀奈 有希奈の妹
ティータ	蒂塔	女 ティータ・フローレス・ブラント
凛	凛	女 凛・リム・ウェムス
クルル	库露露	女 敷島・クルル
敷島	敷島	女 敷島・クルル
ブラント	勃兰特	女 ティータ・フローレス・ブラント

由里亜	由里亚	女 巴由里亚 有希奈＆真紀奈の母
ユリア	由里亚	女 巴由里亚 有希奈＆真紀奈の母
アズ	亚兹	男 アズラエル クルルのぬいぐるみ
はるな	春奈	女 舘川はるな
ハルナ	春奈	女 舘川はるな
マリー	玛丽	女 マリー・ケリー
フィル	菲尔	男 フィリップ・ミヤガワ
フィリップ	菲利普	男 フィリップ・ミヤガワ
ミヤガワ	宫川	男 フィリップ・ミヤガワ
藤吉郎	藤吉郎	男 東村山藤吉郎
カイト	海斗	男 炭谷カイト
ケン	健	男 関屋ケン
ラエル	雷尔	男 ラエル・ブラント ティータの兄で

エルファン	精灵
ライカン	兽人

将星学園	将星学园

ソフィロス	魔棍球
ソフィ	魔棍球
